#######
#!* ###
#x¡+ -#
#x @  #
#x    #
#######